"a" = (/obj/effect/spawner/structure/window/shuttle,/turf/open/floor/plating,/area/shuttle/supply{dir = 1})
"c" = (/obj/structure/shuttle/engine/propulsion{dir = 4},/obj/structure/window/reinforced{dir = 1; layer = 2.9},/obj/structure/window/reinforced{layer = 2.9},/obj/effect/turf_decal/stripes/line,/obj/effect/turf_decal/stripes/line{dir = 4},/turf/open/floor/plating,/area/shuttle/supply{dir = 1})
"e" = (/obj/effect/decal/cleanable/dirt,/obj/effect/turf_decal/stripes/line{dir = 10},/obj/machinery/conveyor_switch/oneway{dir = 8; id = "cargounload"},/turf/open/floor/plasteel,/area/shuttle/supply{dir = 1})
"f" = (/obj/machinery/conveyor{dir = 1; id = "cargoload"},/obj/effect/turf_decal/stripes/line{dir = 8},/obj/effect/turf_decal/stripes/line{dir = 4},/turf/open/floor/plasteel,/area/shuttle/supply{dir = 1})
"i" = (/obj/machinery/conveyor{dir = 1; id = "cargoload"},/obj/effect/turf_decal/stripes/line{dir = 8},/obj/effect/turf_decal/stripes/line{dir = 4},/obj/machinery/light{dir = 4},/turf/open/floor/plasteel,/area/shuttle/supply{dir = 1})
"j" = (/obj/effect/decal/cleanable/dirt,/obj/effect/turf_decal/stripes/line{dir = 1},/turf/open/floor/plasteel,/area/shuttle/supply{dir = 1})
"l" = (/obj/machinery/conveyor{dir = 4; id = "cargounload"},/obj/effect/turf_decal/stripes/line,/obj/effect/turf_decal/stripes/line{dir = 1},/turf/open/floor/plasteel,/area/shuttle/supply{dir = 1})
"m" = (/obj/structure/shuttle/engine/propulsion{dir = 4},/obj/structure/window/reinforced{dir = 1; layer = 2.9},/obj/effect/turf_decal/stripes/line,/obj/structure/window/reinforced{layer = 2.9},/obj/effect/turf_decal/stripes/line{dir = 4},/turf/open/floor/plating,/area/shuttle/supply{dir = 1})
"n" = (/obj/effect/turf_decal/bot,/turf/open/floor/plasteel,/area/shuttle/supply)
"p" = (/obj/docking_port/mobile/supply{dir = 1; dwidth = 7},/obj/machinery/door/airlock/titanium{name = "Supply Shuttle Airlock"; req_access_txt = "31"},/turf/open/floor/plasteel,/area/shuttle/supply{dir = 1})
"q" = (/obj/machinery/button/door{id = "QMLoaddoor2"; layer = 4; name = "Shuttle Right Security Door"; pixel_x = 7},/obj/machinery/button/door{id = "QMLoaddoor1"; layer = 4; name = "Shuttle Left Security Door"; pixel_x = -7},/turf/closed/wall/mineral/titanium,/area/shuttle/supply{dir = 1})
"t" = (/obj/effect/decal/cleanable/dirt,/obj/effect/turf_decal/stripes/line{dir = 1},/obj/machinery/conveyor_switch/oneway{id = "cargoload"},/turf/open/floor/plasteel,/area/shuttle/supply{dir = 1})
"w" = (/obj/machinery/conveyor{dir = 8; id = "cargoload"},/obj/effect/turf_decal/stripes/line{dir = 5},/turf/open/floor/plasteel,/area/shuttle/supply{dir = 1})
"x" = (/obj/machinery/door/poddoor{id = "QMLoaddoor2"; name = "Supply security door"},/obj/machinery/conveyor{dir = 1; id = "cargoload"},/turf/open/floor/mineral/titanium/blue,/area/shuttle/supply{dir = 1})
"y" = (/obj/machinery/door/airlock/titanium{name = "Supply Shuttle Airlock"; req_access_txt = "31"},/turf/open/floor/plasteel,/area/shuttle/supply{dir = 1})
"z" = (/obj/machinery/conveyor{dir = 4; id = "cargounload"},/obj/effect/turf_decal/stripes/line{dir = 1},/obj/effect/turf_decal/stripes/line,/obj/machinery/light,/turf/open/floor/plasteel,/area/shuttle/supply{dir = 1})
"A" = (/obj/effect/turf_decal/bot,/turf/open/floor/plasteel,/area/shuttle/supply{dir = 1})
"B" = (/obj/effect/turf_decal/stripes/line{dir = 1},/obj/effect/turf_decal/stripes/line,/obj/effect/turf_decal/stripes/line{dir = 8},/obj/effect/turf_decal/bot,/obj/effect/turf_decal/loading_area{dir = 8},/obj/machinery/light{dir = 1},/turf/open/floor/plasteel,/area/shuttle/supply{dir = 1})
"D" = (/obj/effect/decal/cleanable/dirt,/turf/open/floor/plasteel,/area/shuttle/supply{dir = 1})
"E" = (/obj/machinery/conveyor{dir = 4; id = "cargounload"},/obj/effect/turf_decal/stripes/line{dir = 1},/obj/effect/turf_decal/stripes/line,/turf/open/floor/plasteel,/area/shuttle/supply{dir = 1})
"F" = (/obj/structure/shuttle/engine/heater{dir = 4},/obj/structure/window/reinforced{layer = 2.9},/obj/structure/window/reinforced{dir = 8; layer = 2.9},/obj/structure/window/reinforced{dir = 1; layer = 2.9},/obj/effect/turf_decal/stripes/line,/turf/open/floor/plating,/area/shuttle/supply{dir = 1})
"G" = (/obj/effect/turf_decal/stripes/line{dir = 1},/turf/open/floor/plasteel,/area/shuttle/supply{dir = 1})
"I" = (/obj/effect/turf_decal/stripes/line,/obj/effect/turf_decal/bot,/obj/effect/turf_decal/stripes/line{dir = 8},/obj/effect/turf_decal/stripes/line{dir = 1},/obj/effect/turf_decal/loading_area{dir = 4},/obj/effect/turf_decal/bot,/turf/open/floor/plasteel,/area/shuttle/supply{dir = 1})
"J" = (/obj/machinery/door/poddoor{id = "QMLoaddoor1"; name = "Supply security door"},/obj/machinery/conveyor{id = "cargounload"},/turf/open/floor/mineral/titanium/blue,/area/shuttle/supply{dir = 1})
"M" = (/turf/closed/wall/mineral/titanium,/area/shuttle/supply{dir = 1})
"N" = (/obj/machinery/conveyor{dir = 8; id = "cargoload"},/obj/effect/turf_decal/stripes/line{dir = 1},/turf/open/floor/plasteel,/area/shuttle/supply{dir = 1})
"O" = (/obj/effect/turf_decal/bot,/obj/effect/decal/cleanable/dirt,/turf/open/floor/plasteel,/area/shuttle/supply{dir = 1})
"R" = (/obj/machinery/conveyor{dir = 6; id = "cargounload"},/obj/effect/turf_decal/stripes/line{dir = 4},/obj/effect/turf_decal/stripes/line,/obj/effect/turf_decal/stripes/line{dir = 1},/turf/open/floor/plasteel,/area/shuttle/supply{dir = 1})
"T" = (/obj/effect/decal/cleanable/dirt,/obj/effect/turf_decal/stripes/line{dir = 8},/turf/open/floor/plasteel,/area/shuttle/supply{dir = 1})
"U" = (/obj/effect/decal/cleanable/dirt,/obj/effect/turf_decal/stripes/line{dir = 9},/turf/open/floor/plasteel,/area/shuttle/supply{dir = 1})
"V" = (/turf/open/floor/plasteel,/area/shuttle/supply{dir = 1})
"W" = (/obj/effect/turf_decal/bot,/obj/effect/decal/cleanable/dirt,/obj/machinery/light{dir = 8},/turf/open/floor/plasteel,/area/shuttle/supply{dir = 1})

(1,1,1) = {"
MFcMFmMFcMFc
MWAnOVBNNNwM
aOOOnVUjGtfa
aAAAADTDVDfa
MVDVVVeVDViM
MIzEElRVVVfM
MMMMMMJpqyxM
"}
